o o o o o o o o o o o o o o g
o x x x o o x x x o o o x g x
o x p o o o o o o o o o g o x
o x o o o o o o o x o g o o x
o o o o o x o o o o g o o o x
o o o o o o o o x g o o o x o
o x x o o o o o g o o o x o o
o x x o o o o g x o o x o o o
o x x o o x g x o o x o o o o
o o o o o g o o o x o o o o o
o o o x g o o o x o o o o o o
o o o g o o o x o o o o o o o
x o g o o o x o o o o o g o o
x g x o o x o o o o o o o g g
g o o o o o o o o o o o o g g
